''''''''''
''''''''''
''''''''''
'''xxx''''
'''x@x''''
'''x x''''
xxxxBxxxx'
xb   +  x'
xxxxxx *x'
xp      x'
xxxxxxxxx'
''''''''''
''''''''''
''''''''''