''''''''''
''''''''''
''''''''''
''''''''''
'xxxxxxxx'
'x  +  xx'
'xp +  @x'
'x  +  xx'
'xxxxxxxx'
''''''''''
''''''''''
''''''''''
''''''''''
''''''''''