''''''''''
''''''''''
xxxxxxxxx'
x      gx'
x*  xxxxx'
xxx+x'''''
''x xxx'''
''x G@x'''
''x xxx'''
''xpx'''''
''xxx'''''
''''''''''
''''''''''
''''''''''