''''''''''
''xxx'''''
''x@x'''''
''xRxxxx''
''x   *x''
''xx r x''
''xx  xx''
''x  + x''
''xx+++x''
''x*   x''
''x  p x''
''xxxxxx''
''''''''''
''''''''''