''''''''''
''''''''''
''''''''''
''''''xxx'
''''''x@x'
'''xxxxYx'
'''x*   x'
'''x  + x'
'xxxx x x'
'xp y   x'
'xxxxxxxx'
''''''''''
''''''''''
''''''''''