''''''''''
''''''''''
''''''''''
''xxxxx'''
''x @ x'''
''x + x'''
''x x x'''
''x+x+x'''
''x   x'''
''x p x'''
''xxxxx'''
''''''''''
''''''''''
''''''''''